##############################################
#     # #  #      #     # #    #   # #  #    #
# # #     #  # ##  # # #    ##  ##     ## ## #
#  # ## ### ##   #  ##   ### ## # ### #    # #
# #    #    # ##  #    ##     #     #   ###  #
# # # #  # #  #  # ###  ### #  # ## # ##    ##
# # # # #    #  #    # #   #  # # #  #   ##  #
#   # #  # ## #   ##  #  # # #     #   ### # #
# ##   #  #    # ## #   ## #   ########    # #
#  # ##  #  ##  #   # ##    # #    #    ###  #
## #    #  #  #  # #   # ###    ##   # #    ##
#   ####  #  #  #  # # # #   #### # #  # ### #
## #    #   #  # #   ##  # ##     #  ##  #   #
#  ## ## # #  #  # ## # #   # ## # # #  #  # #
# #   #  # # #  #   # # # # #  #   #  #  ##  #
# ## #  #  #  # # # # # # #  # ###  #  #    ##
#  #   #  ### #           E# #    # ##  ###  #
##  # #  ###  # #  # #  ##   # ## #  ##     ##
## ##  #  #  #   #  ## # #  #   #  #  # ## # #
#    #  #  #  ##   #   #   ## # ##  #  ## #  #
# ## # # # ##     #  ## ##   #    #  #      ##
# #      #    # ##  #      #  # # # ##### #  #
#  # ###    # #   #  # ##   #  #  # ##  #  # #
##  #   # # #  ##  # #  #    #  # #   #  ##  #
### # #     ##  # #  # # # #  #  ####  #    ##
## ## # #  #  #   # #  # #  #  #  #   #  ### #
#        #  #   ##  # #     # # #   ##  #    #
# # # ##   ## ##  # #   #    #   ### ##  # # #
#  ##   ###   ## #  ####   #   #   #   # ##  #
##   ###    #      #   ##   ###  ### # #    ##
# ##    # ## # ####  ##       # #    #  ###  #
#   ###  ##   #    # #  ##  # # # ### #    # #
# #    #S                    #  # # #  ###   #
# # ### #  #  ##  ## # #   # # #     #    ####
#  #      # #   #  # #   # # #  #### # # ##  #
# #  ## ##   # #  ##  ###  #  #    #  #     ##
# # #   ## #  #  #   #   #  #  ## #  ## ## ###
# #  ##    ##  # # ##  #  # # #   ##    ##  ##
#  #   #### # ## #    #  #  # # #   ####  #  #
# # # #   # # #   # ####   ## # ## #     # # #
# #   # #   # # #  ## # ###   #   #  # ##    #
#   #   # # #    #          #  ##   #     # ##
##############################################