#########
#E     	#
#### #  #
#  # #  #
#  #S   # 
#########
