########### 
#S        #
# ####	# #
# # #   # #
# #   ### #
# #       #
#   ##### #
# #       #
# ##### # #
#     ###E#
###########