######################################################
##   ###    # ##   #      #        ##      # #     # #
#  #  #  ###     # ### ## # ## ###   # ###     ## #  #
# # #   #    # ###     ## #   #   ##  #   # # #     ##
#   ####  # ## #  #####    ##    # ## # #      # ## ##
# #      ###S   #       ##    #            #   E#    #
######################################################