##############################
#S              # # # #      #
###########  #   #   #       #
#  ####  #    # #  #         #
#        #   # # # # #       #
#        #      ##############  
#        #      #E#  #       #
#        #     #  #  #       #
#    #####     #  #  #       #
#    #            #  #       #
#    #    ###### #   #       #
#     #         #    #       #
#      #########             #       
#     ##########     #       #
#    ############    #       #
#   ###############  #       #
#  ################          #
# ##################         #
#####################        #
##############################

