#############
#     S     #
#E          #
#           #
#############
