############################################################
#   ##   ##  #    #   #   #     ##  #   #   #    #   # #  ##
# #    #    #  ## # #   #   ###    #  #   #  # #   ##   #  #
#  ###  # ##  ###   # ##  ##   ###  #  ##  # #  ## #  #  # #
###   ##  #  # # ####  # #   #    #  # # # # ## #    # #   #
#   #    #  #        # # # ## ###  # #   # #  ##  ## #   # #
# ## ### # #  ## # ##  # #  #    # #  ## #  #    #  #  ## ##
#  # #   # ##  #  #   # # # # # #  # # #  #  ## #  #  ##   #
## # # ##     #  #  ##    # # # # #  #  #  #   #  ## #   # #
#  # # #  # ## ##  #   # ##   ##  # # #  #  ##  # #   # #  #
# #  # # # #      # # #    ##  # #  #  #  # ### #   # # ## #
# # #   ##   ## ##     # ## # #  ##  #   ##  #  ####   #   #
# #   #   ##  ##   # # #    #  #   #   ##   #  #    ##   # #
#  ## ###  ##    ## #   ## #  # ##  # #   ##  ## ## # ###  #
##   #   #   # ##    ###    # #   # # # # #  #   #  #   ## #
# ##   #  ## ##   ## #   ###   ## #  ##  #  #  ##  #  #    #
# # ###  # #   # #   # # #   #     #   # # #  #  #  #  #####
#   #  # # ### #  # #  ##  # #####  ##   #   # #  #  #     #
# #  #       # # #  ##    # #     # #  ## # ##   # # ## ## #
#  #   #### #    # #   ####   ###  #  #    #   #   #  #  # #
##  ####  #  # ##  # ##    # #   #  #   ## ###  # # #  #  ##
## #     ###  # # #   # ## #  ## ##  ####     ###    #  #  #
#  ## ### # #   # ## #   #  #  #   #     ## #     ##  #  # #
##    #       # #   ## ##  # #  ##  ## #   # # ### # ### # #
# ### # ### ##  ### #  #  #    #   #  #  ##   #  #    #  # #
# #   # #  #   #  # # ## #  # #  ## # # #   #  #   ##  # # #
#   ##  ##  # #  ## # #    # ###      # # ## #  # #  # # # #
####   #  # #   #   # # # #   ## # # ##   #  ##  # #   # # #
#    #  #   # # # ##   #### #   #  #   ### #   #    #### # #
# # #  # ##  #  # #  #  #   ###  ##  ##     # # ### #    # #
#  #  #    #   #  # #  ## ##   # #  #   ## #      # # ###  #
##  # # ## # ## # # # #     # #  ##   ##   # # # #  # #   ##
# #  #  #  #    #  #   # ##   # #   #   # ## #  #  #   # ###
#  #  #  #  ## #  #  # #  # ### # ## ## #     # # ## # #  ##
##   #  # #   ## # # # ##  #    ##    #  #### # #   #  ##  #
#  # # #   ##    #   #   # # # #   ## ####   #   ##  #   # #
# # #  ## ## ####  # ## ## #  #  #  #      # # #  ## # #  ##
#    #  # #  #  ## #   #    #   # ## ### # # #  #  # ## #  #
# ## ## #   #  #   # ##  ### # #        # #  ##  # #     # #
#  #  # # # # #  #  #   #     #  # ## # #   #   #   ####   #
## ## #   # # ## # #  ##  ### # ## # #    ## ###  #     ## #
#   #  ###  #    #   #   #  # # #  #  # ##       #  #####  #
# ##  #  # #  ###  ## # #  #  ##  # #  #   # ####  #      ##
#  # #  #  # #   # #    # #  # # #   #   ##  #    #  # ### #
###  # # # #   #  ## # #  # #    # # # # #  #  ###  # #    #
#   #       ###  #   #  # # ## ##  #   ##  # #    # #  ### #
# # # # ####   # # ## ##  #    ## ##### # #   ####   #     #
#  #  ##     ### #      #   ###    #    #   #     # #  # # #
##  #   # # #    ###### # ##   ###  ###  ### #### # # #  # #
#  # ##  #   # ##     # ###  #    #    # #   #  #   # # #  #
# #    # # # #  # ### #  S  # ###  ## #    #  # # ## ##  # #
# # ## # # # # #  #   # ## #     #      ### # #  ##     #  #
#    # #  #     #  # #    # # ## # # ###    #  #    #   E# #
# ## #  # # ###  # #  # #   # ##   #   # ##  # ### ## # # ##
##   # #   #   ##  ## ##  ###   # #  #   # # #    #     #  #
#  ##   ## # #    #     ##   ##  #  # #### # ####   ###  # #
## #  #  # # ### # # ##  # #   # # #       #     # #    #  #
#  ###  #  #    #   #   #  # #   # # ## ##  ## ## ## # ### #
##    ### # ### # # # ##  # # #### ## #  # # # #     ## #  #
#  ##           # #      #              #    #   # #      ##
############################################################