#####
#S  #
#  ##
## ##
# E #
#####